s,8,1,2
v,72,0,0,0
v,72,1,0,0
v,72,2,0,0
v,72,3,0,0
v,48,4,0,0
v,72,3,0,1